// Section General
Name	*	Название
Type	*	Тип
Model	*	Модель
Manufacturer	*	Производитель
Operation	*	Вид обработки
NumAxes	*	Количество координат
Description	*	Описание
// end section

// Section Word Replacement
Replace	*	*
RegExp	*	*
// end section

// Section Word Definition
LineNumber	N	Номер кадра программы
HorizontalAxis	X	Перемещение параллельно оси X
HorizontalAxisInc	U	Относительная координата независимо от режима
HorizontalAxisAbs	U	Абсолютная координата независимо от режима
HorizontalAxisMin	X	Минимальный предел перемещения для кода DefLimitsNeg
HorizontalAxisMax	X	Максимальный предел перемещения для кода DefLimitsPos
HorizontalAxisAct	X	Активный предел перемещения для кода ActiveLimits
VerticalAxis	Y	Перемещение параллельно оси Y
VerticalAxisInc	V	Относительная координата независимо от режима
VerticalAxisAbs	V	Абсолютная координата независимо от режима
VerticalAxisMin	Y	Минимальный предел перемещения для кода DefLimitsNeg
VerticalAxisMax	Y	Максимальный предел перемещения для кода DefLimitsPos
VerticalAxisAct	Y	Активный предел перемещения для кода ActiveLimits
SpindleAxis	Z	Перемещение параллельно оси Z
SpindleAxisInc	W	Относительная координата независимо от режима
SpindleAxisAbs	W	Абсолютная координата независимо от режима
SpindleAxisMin	Z	Минимальный предел перемещения для кода DefLimitsNeg
SpindleAxisMax	Z	Максимальный предел перемещения для кода DefLimitsPos
SpindleAxisAct	Z	Активный предел перемещения для кода ActiveLimits
HorizontalRotationAxis	A	Угловое перемещение вокруг оси X
HorizontalRotationAxisInc	*	*
HorizontalRotationAxisAbs	*	*
HorizontalRotationAxisMin	A	Минимальный предел перемещения для кода DefLimitsNeg
HorizontalRotationAxisMax	A	Максимальный предел перемещения для кода DefLimitsPos
HorizontalRotationAxisAct	A	Активный предел перемещения для кода ActiveLimits
VerticalRotationAxis	B	Угловое перемещение вокруг оси Y
VerticalRotationAxisInc	*	*
VerticalRotationAxisAbs	*	*
VerticalRotationAxisMin	B	Минимальный предел перемещения для кода DefLimitsNeg
VerticalRotationAxisMax	B	Максимальный предел перемещения для кода DefLimitsPos
VerticalRotationAxisAct	B	Активный предел перемещения для кода ActiveLimits
SpindleRotationAxis	C	Угловое перемещение вокруг оси Z
SpindleRotationAxisInc	*	*
SpindleRotationAxisAbs	*	*
SpindleRotationAxisMin	C	Минимальный предел перемещения для кода DefLimitsNeg
SpindleRotationAxisMax	C	Максимальный предел перемещения для кода DefLimitsPos
SpindleRotationAxisAct	C	Активный предел перемещения для кода ActiveLimits
FunctionCode	G	Подготовительная функция (G-код)
MiscFunctionCode	M	Вспомогательная функция (M-код)
FeedCode	F	Велечина подачи
FeedCodeNM	FB	Велечина подачи в кадре где она указана
SpeedCode	S	Скорость вращения шпинделя
SpeedCodeMill	S	Скорость вращения фрезерного шпинделя
SpeedCodeTurn	S	Скорость вращения токарного шпинделя
ToolCode	T	Номер инструмента
TurretNum	C	Номер турреты в которой находится инструмент
DwellTime	E	Время выдержки
CycleDwellTime	P	В случае резьбовых циклов, если задано в кадре цикла и значение больше чем по умолчанию (SpindleReverseTime), то учитывается оно. В противном случае берется значение по умолчанию
GlobalDwell	V	Если значение задано и в кадре после команды Dwell не задано DwellTime, то в качестве времени выдержки используется глобальное время выдержки
CircleHorzCenter	I	Координата центра дуги по оси X. Тип ее зависит от значения параметра CircleCenterMode
CircleHorzCenterAbs	I	Координата всегда абсолютная не зависимо от параметра CircleCenterMode
CircleHorzCenterInc	I	Координата всегда относительная не зависимо от параметра CircleCenterMode
CircleVerticalCenter	J	Координата центра дуги по оси Y
CircleVerticalCenterAbs	J	Координата всегда абсолютная не зависимо от параметра CircleCenterMode
CircleVerticalCenterInc	J	Координата всегда относительная не зависимо от параметра CircleCenterMode
CircleDepthCenter	K	Координата центра дуги по оси Z
CircleDepthCenterAbs	K	Координата всегда абсолютная не зависимо от параметра CircleCenterMode
CircleDepthCenterInc	K	Координата всегда относительная не зависимо от параметра CircleCenterMode
CircleRadius	R	Радиус дуги
CircleFullTurns	T	Полное число оборотов окружности заданной G2/G3
DiaCompOffset	D	Номер корректора на диаметр
DiaCompCodeVal	d	Текущее значение кода коррекции на токарную кромку
LengthCompOffset	H	Номер корректора на длину
RapidClearanceLevel	C	Глубина выхода из цикла
RapidClearanceLevel1	R	*
RapidClearanceLevel2	R	*
DrillRepeatCycles	*	Число повторов в циклах сверления
DiaCompHorizVec	P	Коэффициент коррекции по горизонтали
DiaCompVerticalVec	Q	Коэффициент коррекции по вертикали
ThreadParm	*	*
ProgramNumber	P	Номер управляющей программы
ProgramStartEnd	:	Начало программы/подпрограммы
CommentStart	(	Начало комментария. Должен быть определен для работы раскраски текста
CommentEnd	)	Окончание комментария. Должен быть определен для работы раскраски текста
ModalCommentOn	{	Все строки программы после этого символа и до конца модального комментария (ModalCommentOff) являются комментарием
ModalCommentOff	}	Все строки программы с модального комментария (ModalCommentOn) и до этого символа являются комментарием
EndOfLine	\	Конец кадра программы
BlockSkip	/	Пропуск участка программы начиная с этого символа до конца строки
BlockDebug	/	Пропуск участка программы. Зависит от флага в Стойка-Параметры Стойка-Отладка
ProgrammingBeginEnd	%	Начало файла программы. Должен присуствовать в файле, иначе не работает MainInitStr
DefineCycle	@	251 цикл активен @251
PeckIncrementDepth	Q	Шаг сверления для цикла DrillPeckCycle. Пишется в 222 регистр
DrillRef	R	Плоскость отхода для цикла DrillPeckCycle, DrillDwellCycle. Пишется в 201 регистр
DrillRefRad	R	Плоскость отхода для цикла RHTappingCycleX. Пишется в 201 регистр. Всегда в радиусах (не зависит от мастшабных коэффициентов)
DrillRelR	R	Параметры цикла DrillCycleRel
DrillRelZ	Z	Параметры цикла DrillCycleRel
DrillRelW	W	Параметры цикла DrillCycleRel
ProgramCopyStart	P	Начало копии программы. Используется подготовительной функцией ProgramCopy
ProgramCopyEnd	Q	Конец копии программы. Используется подготовительной функцией ProgramCopy
DiaCompOffsetVal	*	Велечина коррекции на диаметр
PunchStep	B	Шаг высечки
Register	R	Значения координат в управляющей программе можно задавать с помощью буквенного обозначения - регистра. Значение регистра задается таким образом: Rn=a, где n - номер регистра, a - число. Встретив в тексте программы Rn, NCManager будет интерпретировать его как число a
RepeatNumber	*	Количество повторений	цикла (участка программы)
TurnRoughDepthU1	U	Шаг зазубления. Используется в TurnRoughCycle
TurnRoughDepthW1	W	Шаг зазубления. Используется в TurnRoughCycle
TurnRoughDepthR	R	Велечина отхода. Используется в TurnRoughCycle. #9000. Отход вдоль оси резания
TurnRoughDepthR2	R	Велечина отхода 2. Отход вдоль оси не резания. Заносится в регистр 4322
TurnRoughDepthD	D	Шаг зазубления и велечина отхода. Используется в TurnRoughCycle
ChamferAngle	A	Велечина угла в снятий фасок с помощью "A". Используется в кадрах с линией интерполяцией. G01X100.A135
TurnConeX	*	Расстояние и направление конуса по оси X (на радиус). Используется в TurnCutCycle
TurnConeZ	*	Расстояние и направление конуса по оси Z. Используется в TurnFaceCycle
TurnThreadP	*	*
TurnThreadR	*	*
TurnThreadQ	*	*
NoMove	&	Признак того, что кадр невыполняется. Для стойки НЦ31
StartAngleGrooveCycle	Q	Начальный угол. Используется в цикле GrooveCycle
DummyN	*	Пустая команда. Если в разделе "Word Defenition" есть строка такого вида: DummyN A, где N - любое число, а A - символ то символ A, не будет обрабатываться программой NCManager
MillCircU	U	Параметр фрезерного цикла - диаметр фрезерования. Регистр 223
MillRectU	U	Параметр фрезерного цикла - длина фрезерования. Регистр 218
MillRectV	V	Параметр фрезерного цикла - ширина фрезерования. Регистр 219
MillO	O	Параметр фрезерного цикла - угол с осью + X. Регистр 224
MillCR	,R	Параметр фрезерного цикла - радиус скругления кармана. Регистр 220
MillR	R	Параметр фрезерного цикла - базовая плоскость обработки. Регистр 203
MillZ	Z	Параметр фрезерного цикла - глубина обработки. Регистр 201
MillQ	Q	Параметр фрезерного цикла - тип обработки (код). Q0-5 - обработка двусторонняя. Q10-15 - обработка одностороняя
MillK	K	Параметр фрезерного цикла - глубина прохода. Регистр 202
MillP	P	Параметр фрезерного цикла - ширина фрезерования в % от диаметра фрезы. Регистр 370
MillI	I	Параметр фрезерного цикла - припуск чистовой на сторону. Регистр 368
MillJ	J	Параметр фрезерного цикла - припуск чистовой на дне. Регистр 369
MillW	W	Параметр фрезерного цикла - велечина отхода в конце цикла. Не в регистре
MillL	L	Параметр фрезерного цикла - метод погружения фрезы (вниз или под углом). Не в регистре
MillJ1	J	Параметр фрезерного цикла - ширина припуска. Регистр 342
MultiParameter0...9	P	Встреченный в программе символ распознается в зависимости от цифры, которая означает его положение в строке
AddCoord00	E	Дополнительные оси в станке. 00, 01, 02 ... - порядковый номер, двузначный например для перемещения противошпинделя. Требуется описать в разделе Other параметр AddCoord00Axis (имя оси в файле станка)
ProgramCopyChar	-	Повтор части программы по номерам кадра. Формат вызова N30-45. Выполнить программу с кадра 30 до 45. Возможность задать число повторов RepeatNumber
BeamCurrent	S	Ток луча в мА. Для проекта ЭЛС
FocusCurrent	SL	Ток фокуса в мА. Для проекта ЭЛС
SweepCurrent	SF	Для проекта ЭЛС
TiltA	A	Абсолютный угол наклона вокруг оси X
TiltB	B	Абсолютный угол наклона вокруг оси Y
TiltC	C	Абсолютный угол наклона вокруг оси Z
TiltAI	A	Относительный угол наклона вокруг оси X
TiltBI	B	Относительный угол наклона вокруг оси Y
TiltCI	C	Относительный угол наклона вокруг оси Z
TiltAReg	201	Номер регистра куда запишется угол поворота A станка
TiltBReg	202	Номер регистра куда запишется угол поворота B станка
TiltCReg	203	Номер регистра куда запишется угол поворота C станка
TiltMainAngleReg	47	Угол с рабочей плоскостью до поворота
TiltType	L	Тип поворота. 0 - нет движения станка, 1 - поворот без линейной компенсации, 2 - поворот с линией компенсации
TiltToolOffset	L	Смещение инструмента в случае TiltType=2. Расстояние в направлении оси инструмента между начальной и конечной позицией инструмента
PlaceToolAxes	L	Описывает какие две оси станка участвуют в повороте для G кода. PlaceTool 1,2,3(2) L1 - AB, L2 - BC, L3 - AC
IKGoTo	I	Переход на метку если это не дуга
AdditionalTextStart	Ф	Любой уникальный символ. Если в стойке описаны тексты подпрограмм пользователя и определен этот символ, то при сохранении файла УП, тексты подпрограмм не сохраняются в тексте УП
LabelFirst	«»»	Символ начала метки для LabelType BaltSys. Если символ кавычки, то его нужно заключить в кавычки при определении
LabelLast	«»»	Символ конца метки для LabelType BaltSys. Если символ кавычки, то его нужно заключить в кавычки при определении
PolarDist	PR	Полярный радиус
PolarAngle	PA	Полярный угол абсолютный
PolarAngleInc	IPA	Полярный угол относительный
VariablePrefix	*	Начало имени переменной. Символ (уникальный!) для описания начала имени переменной
VariableEnd	*	Конец имени переменной. Символ (уникальный!) для описания конца имени переменной
// end section

// Section Function Definition
Rapid	0	Программирование холостого хода (позиционаривание инструмента)
Linear	1	Линейная интерполяция. Программирование отрезка
CircularCW	2	Круговая интерполяция. Движение по часовой стрелке. Программирование дуги окружности по часовой стрелке
CircularCCW	3	Круговая интерполяция. Движение против часовой стрелки. Программирование дуги окружности против часовой стрелки
CircularCWM	2	Круговая интерполяция. Движение по часовой стрелки для НЦ-31. Перенос кадра писать ненужно. G2 X100 Z200 [F5] P0 P90
CircularCCWM	3	Круговая интерполяция. Движение против часовой стрелки для НЦ-31
PolarCW	2	Круговая интерполяция в полярных координатах. Движение по часовой стрелке. Программирование дуги окружности по часовой стрелке
PolarInterp	112	Включение режима полярной интерполяции
PolarInterpCancel	113	Выключение режима полярной интерполяции
PolarCoordModeOn	16	Включения режима работы в полярных координатах
PolarCoordModeOff	15	Выключение режима работы в полярных координатах.
CylindricInterp	*	*
CylindricInterpCancel	*	*
PolarCCW	3	Круговая интерполяция в полярных координатах. Движение против часовой стрелки. Программирование дуги окружности против часовой стрелки
PolarCenter	6	Полярный центр. Задание центра дуги для круговой интерполяции в полярных координат полюса
ArcCenter	*	*
Dwell	4	Высотой
ExactStop	9	Торможение в конце кадра по специальному закону
SpiralCW	12	Круговая интерполяция по часовой стрелке в плоскости XY с одновременной линейной интерполяцией по координате Z. Задаются параметры дуги окружности, шаг винтовой линии под адресом K и общая велечина перемещения по координате Z. Если параметр K не задан, то осуществляется движение в пределах одного оборота
SpiralCCW	13	Круговая интерполяция по часовой стрелке в плоскости XY с одновременной линейной интерполяцией по координате Z. Задаются параметры дуги окружности, шаг винтовой линии под адресом K и общая велечина перемещения по координате Z. Если параметр K не задан, то осуществляется движение в пределах одного оборота
XYPlane	17	Программирование в плоскости XY
ZXPlane	18	Программирование в плоскости ZX
YZPlane	19	Программирование в плоскости YZ
InchUnit	20	Программирование в дюймах
MetricUnit	21	Программирование в миллиметрах
ProgramCopy	25	Вызов подпрограммы, тело которой состоит из кадров с номерами от ProgramCopyStart до ProgramCopyEnd. Пример: G25P10Q25 – выполнить с 10-го по 25-ый кадр и продолжить после текущего
ProgramCopyMP	14	Команда повтора (стойка millplus). Повторить выполнения части программы в указанном номерами кадров диапазоне. G14 N1=... {N2=...} {J...} {K...}. N1 – ProgramCopyStart. N2 – ProgramCopyEnd. J – RepeatNumber. K – не используется
ReturnToRef	31	Выход в фиксированную позицию 1 (координата X берется из регистра №037, Y - из регистра №038, Z - из регистра №039)
ReturnToRef2	32	Выход в фиксированную позицию 2 (координата X берется из регистра №049, Y - из регистра №050, Z - из регистра №051)
ReturnToRef3	28	Выход в фиксированную позицию 3 (координата X берется из регистра №061, Y - из регистра №062, Z - из регистра №063)
ReturnToRef4	27	Выход в фиксированную позицию 4 (координата X берется из регистра №073, Y - из регистра №074, Z - из регистра №075)
ReturnToZero	29	Выход в нулевые точки станка по всем координатам
ToolCompCancel	40	Отмена плоскостной коррекции
CompCancelNext	40	*
RetractComp	1000	Выключает коррекцию до пересечения
ToolCompLeft	41	Плоскостная коррекция. Инструмент находится слева от обрабатываемой поверхности, если смотреть от режущего инструмента в направлении его движения относительно изделия
ToolCompRight	42	Плоскостная коррекция. Инструмент находится справа от обрабатываемой поверхности, если смотреть от режущего инструмента в направлении его движения относительно изделия
ToolCompLeftInToolNumber	*	Плоскостная коррекция по номеру инструмента. Контур находится справа от инструмента
ToolCompRightInToolNumber		Плоскостная коррекция по номеру инструмента. Контур находится слева от инструмента
LengthCompOn	43	Положительная коррекция на длину. Положительная коррекция инструмента (ввод коррекции со своим знаком)
LengthComp	44	Отрицательная коррекция на длину. Отрицательная коррекция инструмента (ввод коррекции с противоположным знаком)
LengthOffsetIncr	45	Положительная осепараллельная коррекция
LengthOffsetDecr	46	Отрицательная осепараллельная коррекция
LengthOffsetIncr2X	47	Двойная положительная осепараллельная коррекция
LengthOffsetDecr2X	48	Двойная отрицательная осепараллельная коррекция
LengthOffsetIncr2XITN	*	Двойная положительная осепараллельная коррекция по номеру инструмента
LengthOffsetDecr2XITN	*	Двойная отрицательная осепараллельная коррекция по номеру инструмента
LengthOffsetCancel	49	Отмена осепараллельной коррекции
ScalingCancel	50	Масштабирование выкл. Все коэффициенты устанавливаются в «1»
ScalingOn	51	Масштабирование вкл. Масштабные коэффициенты по осям указываются после X,Y,Z. I, J, K при этом умножаются на коэфф для соответствующей оси и на свой, который задан в этой строке. G51X0.5 – Координаты X и I имеют один масштабный коэффициент — 0.5. G51X0.5I2. В этом случае все X умножаются на 0.5 все I умножается на 0.5*2=1
ScalingOn1	52	Масштабирование вкл. Масштабные коэффициенты по осям указываются после X,Y,Z в процентах
WorkCoordSys1	54	Рабочая система координат - 1
WorkCoordSys2	55	Рабочая система координат - 2
WorkCoordSys3	56	Рабочая система координат - 3
WorkCoordSys4	57	Рабочая система координат - 4
WorkCoordSys5	58	Рабочая система координат - 5
WorkCoordSys6	59	Рабочая система координат - 6
ExactStop2	61	*
TappingCycle	63	Цикл нарезания правосторонней резьбы
CuttingCycle	64	Цикл вырезания
HighSpeedPeck	73	Высокоскоростное глубокое сверление
LeftHandTapping	74	Цикл нарезания левосторонней резьбы
FineBoring	98	Цикл растачивания
CancelCycle	80	Отмена постоянного цикла
DrillCyclePlane	81	Цикл сверления, зацентровки зависит от плоскости интерполяции как и другие
DrillCycle	81	Цикл сверления, зацентровки вдоль оси Z. Цикл сверления, зацентровки. Перед выполнением сохраняет текущую плоскость интерполяции, устанавливает G17, работает, при отмене восстанавливает плоскость до вызова
DRILLCYCLEX	87	Цикл сверления, зацентровки вдоль оси X. То же что DrillCycle только установит G19
DRILLCYCLEY	87	Цикл сверления, зацентровки вдоль оси Y. То же что DrillCycle только установит G18
DRILLCYCLEPLANE	81	Цикл сверления, зацентровки. Работает в текущей плоскости интерполяции
DrillCycle_HM	81	Цикл сверления, зацентровки. Параметры цикла берутся из регистров
DrillCycle_HMC	81	Цикл фаски.(HH). Цикл сверления, зацентровки. Параметры цикла берутся из регистров
DrillCycle_HN	81	Цикл сверления, зацентровки. Аналогичен DrillCycle_HM, но действует только в одном кадре и завершает работу цикла, если он был активирован ранее
DrillCycleRel	81	Цикл сверления, зацентровки параметры в регистрах. R – абсолютное положение плоскости отверстия. Z – относительная глубина отверстия. W – плоскость отвода. G81X10Y20R10Z-30W4. R - DrillRelR в регистре 201. Z – DrillRelZ в регистре 203. W – DrillRelW в регистре 204
DefMPParams	1000	Заполняет регистр. Значения берутся из переменных: DrillRelR, DrillRelZ, DrillRelW, DrillRelX, DrillMPI, DrillMPJ, DrillMPK, DrillMPK1 - dummy. R - DrillRelR в регистре 201. Z - DrillRelZ в регистре 203. W - DrillRelW в регистре 204. X - DrillRelX - время 205
DrillCycle_MP81	81	Цикл сверления для Millplus стойки. Параметры цикла берутся из регистров 201, 203, 204, 205. Координата Z в цикле определяет базовую плоскость цикла
ForceCycle	1000	Выполнить последний работающий цикл. Параметр ForcedCycles должен быть включен
DrillDwellCycle	82	Цикл сверления, зенкерования
DrillPeckCycle	83	Цикл глубокого сверления
DrillPeckCycleX	87	*
DrillPeckCycleZ	83	*
RHTappingCycleZ	84	Цикл нарезания резьбы метчиком вдоль оси Z не зависимо от плоскости интерполяции. Цикл на ХХ идет на расстояние DrillRef, включает рабочий ход и сверлит до координаты Z. Затем на рабочем ходу возвращается до уровня DrillRef, переключается на ХХ и возврашается на исходный уровень. Учитывается время CycleDwellTime и SpindleReverseTime
RHTappingCycleX	88	Цикл нарезания резьбы метчиком вдоль оси X не зависимо от плоскости интерполяции. Также как в RHTappingCycleZ, только сверление вдоль оси X
RHTappingCyclePlane	84	Цикл нарезания резьбы метчиком. Направление сверления зависит от плоскости интерполяции. Из исходной плоскости на ХХ опускается в координату DrillRef, далее на РХ в координату конечной точки отверстия, Затем на РХ поднимается до DrillRef и в случае G98 на ХХ поднимается на исходную плоскость. Ось сверления зависит от активной плоскости интерполяции
RightRHTappingCycle	84.2	*
ReamCycle	85	Цикл растачивания, развертывания
BoreCycle	86	Цикл растачивания
BackBoreCycle	87	Цикл растачивания
BoreDwellCycle	88	Цикл растачивания
ReamDwellCycle	89	Цикл растачивания
DrillCycleNUMER	81	Цикл сверления. Параметры находятся в регистрах
RectPoketCycle	72	Не модальный цикл фрезерования прямоугольного кармана из текущей позиции. XY – размер кармана, Q — шаг в сторону (замена на J). D — корректор на диаметр инструмента. Инструмент не возвращается в начальную позицию. G0X20Y0; в центр G1Z-10F20; опустить G72X100Y50Q5D10; обработка
RectPoketCycleQ	72	Не модальный цикл фрезерования прямоугольного кармана из текущей позиции. XY – размер кармана, Q — шаг в сторону (зашито в цикле). D — корректор на диаметр инструмента. Инструмент не возвращается в начальную позицию. G0X20Y0; в центр G1Z-10F20; опустить G72X100Y50Q5D10; обработка
CircularPoketCycle	12	Не модальный цикл фрезерования круглого кармана из текущей позиции. I – начальный диаметр. K — конечный диаметр. Q – шаг в сторону (описать как еще один CircleVerticalCenter - Q), D – корректор на диаметр. Инструмент возвращается в начальную позицию. I < D – ошибка. G90G0X0Y0. G1Z-22. G12I6K30Q5D12F100
TurnClearCycle	70	Токарный чистовой цикл. G70P10Q20. P_ - ProgramCopyStart. Q_ - ProgramCopyEnd
TurnRoughCycle	71	Токарный цикл чернового точения. Format F18: G71 U(1) R_; G71 P_ Q_ U(2) W_ F_ S_; Format F15 G71P_Q_U(2)_W_I_K_D_F_S; U(1)- TurnRoughDepthU1 R_- TurnRoughDepthR P_ - ProgramCopyStart Q_ - ProgramCopyEnd U(2)- HorizontalAxisInc W_ - SpindleAxisInc D_ - TurnRoughDepthD
TurnFacingCycle	72	Токарный цикл чернового поперечного точения. Format F18: G72 U(1) R_ ; G72 P_ Q_ U(2) W_ F_ S_ ; Format F15 G72P_Q_U(2)_W_I_K_D_F_S; U(1)- TurnRoughDepthU1 R_- TurnRoughDepthR P_ - ProgramCopyStart Q_ - ProgramCopyEnd U(2)- HorizontalAxisInc W_ - SpindleAxisInc D_ - TurnRoughDepthD
TurnLoopCycle	73	Токарный цикл удаления припуска. Format F18: G73 U(1) W(1) R_ ; G73 P_ Q_ U(2) W(2) F_ S_ ; Format F15 G73P_Q_U(2)W(2)I_K_D_ F_S; U(1) - TurnRoughDepthU1 W(1) - TurnRoughDepthW1 R_ - TurnRoughDepthR P_ - ProgramCopyStart Q_ - ProgramCopyEnd U(2)- HorizontalAxisInc W(2) - SpindleAxisInc I_  - TurnRoughDepthU1 K_ - TurnRoughDepthW1 D_ - TurnRoughDepthD
TurnGroovZCycle	74	Format F18: G74 R(1); G74X(U)_Z(W)_P_Q_R(2)F_ Format F15 G74 X(U)_ Z(W)_ I_ K_ F_ D_ R(1) - TurnRoughDepthR P_ - TurnGroovDepthP R(2) – TurnRoughDepthR2 I_ - TurnGroovDepthP D_ - TurnRoughDepthR
TurnGroovXCycle	75	Format F18: G75 R(1); G75X(U)_Z(W)_P_Q_R(2)F_ Format F15 G75 X(U)_ Z(W)_ I_ K_ F_ D_ R(1) - TurnRoughDepthR Q_- TurnGroovDepthQ(пишется в регистр 4321) P_ - TurnGroovDepthP R(2) – TurnRoughDepthR I_ - TurnGroovDepthQ D_ - TurnRoughDepthR
TurnThreadACycle	76	Format F18: G75 R(1); G75X(U)_Z(W)_P_Q_R(2)F_ Format F15 G75 X(U)_ Z(W)_ I_ K_ F_ D_ R(1) - TurnRoughDepthR P_ - TurnGroovDepthP R(2) – TurnRoughDepthR I_ - TurnGroovDepthP D_ - TurnRoughDepthR
TurnCutCycle	90	Однопроходный модальный токарный цикл черновой обработки. G90X(U)Z(W)I_ I_  - TurnConeX
TurnFaceCycle	94	Цикл обтачивания торцов. G94X(U)Z(W)K K_ - TurnConeZ
TurnCutRoughCycle	90	Многопроходной модальный токарный цикл черновой обработки. TurnRoughDepthR – конусность. TurnGroovDepthP - глубина резания на проход
TurnFaceRoughCycle	90	Многопроходный модальный токарный цикл черновой обработки. TurnRoughDepthR, TurnGroovDepthP
AbsoluteUnit	90	Программирование в абсолютных координатах
IncrementalUnit	91	Программирование в относительных координатах
ZeroPresetRel	92	Новая система координат устанавливается так, чтобы текущая точка имела в ней заданные в этом кадре координаты. Возможен поворот на заданный угол
ZeroPreset	92	Заданные значения координат становятся началом новой системы координат. Возможен поворот на заданный угол
FeedPerMin	94	Программирование подачи инструмента в мм/мин или в град/мин (для круговых координат)
FeedPerRev	95	Программирование подачи инструмента в мм/об или в град/об (для круговых координат)
SpeedInSFM	96	Программирование скорости вращения шпинделя в метрах в минуту
SpeedInRpm	97	Программирование скорости вращения шпинделя в оборотах в минуту
SetMaxSpeed	50	Задать максимальную скорость вращения для режима постоянной скорости резания. Скорость задается через SpeedCode. G50S2000(задали макс обороты в 2000об/мин) G97S250 (вкл резания с скоростью 250м/мин — обороты будут расчитаны от диаметра обработки)
FixCutSpeed	96	Включить режим постоянной скорости резания
UnFixCutSpeed	97	Выключить режим постоянной скорости резания
ReturnToStartPlane	98	Возврат к начальной плоскости
ReturnToRefPlane	99	Возврат к ссылочной плоскости
PunchCancel	10	Выключение режима высечки
PunchStart	12	Включение режима высечки
MirrorRotateOff	*	Отмена зеркального отображения и вращения с шагом 90
MirrorRotate1	*	Зеркальное отображение и вращение с шагом 90. Зеркальное отображение относительно оси X: +Y становится -Y
MirrorRotate2	*	Зеркальное отображение и вращение с шагом 90. Вращение на угол 180 (или зеркальное отображение относительно обеих осей): +Y становится –Y, а +X становится –Х
MirrorRotate3	*	Зеркальное отображение и вращение с шагом 90. Зеркальное отображение относительно оси Y: +X становится -X
MirrorRotate4	*	Зеркальное отображение и вращение с шагом 90. Зеркальное отображение и вращение на угол 90 (замена X на Y с изменением знака): +X становится –Y, а +Y становится –Х
MirrorRotate5	*	Зеркальное отображение и вращение с шагом 90. Вращение против часовой стрелки на 90 (зеркальное отображение относительно биссектрисы угла и относительно оси Y): +X становится +Y, а +Y становится –Х
MirrorRotate6	*	Зеркальное отображение и вращение с шагом 90. Зеркальное отображение относительно биссектрисы угла (обратная функция = взаимной замене X и Y): +X становится +Y, а +Y становится +Х
MirrorRotate7	*	Зеркальное отображение и вращение с шагом 90. Вращение против часовой стрелки на 90 (зеркальное отображение относительно биссектрисы угла и относительно оси X): +X становится -Y, а +Y становится +Х
TechTable	801	Технологическая таблица (для резательных машин). После кода команды в квадратных скобках указывается номер технологической таблицы
EnableExtraArc	45	Разрешение дополнительных дуг. Разрешает вставку дополнительных дуг в негладких вершинах траектории. Действует в одном кадре
EnableExtraArcModal	46	Разрешение дополнительных дуг. Разрешает вставку дополнительных дуг в негладких вершинах траектории. Действует до отмены
DisableExtraArcModal	80	Отмена разрешения дополнительных дуг. Отменяет EnableExtraArcModal
ParToNext	35	Перпендикулярно к следующему. Направление коррекции параллельно следующему кадру
CallMacro	65	Вызов макрокоманды пользователя. Значения всех адресов, кроме GLNOP, заданных в этом кадре интерпретируются как значения соответствующих регистров, а не по общим правилам
ModalCallMacro	66	Вызов модальной макропрограммы. Параметры те же что в CallMacro
ModalCallMacro2	66	Только передает параметры в вызываемую ПП не отрабатывая движений в кадре. Параметры те же что в CallMacro но смещены на 500, т. е. A=#501
ModalCallCancel	67	Конец вызова ModalCallMacro, ModalCallMacro2
DummyN	*	Пустая команда. Если в разделе "Function Definition" есть строка такого вида: DummyN A B C, ГДЕ N, A, B – любые числа, C – Y или N то подготовительная функция, номер которой равен A, не будет обрабатываться программой NCManager
SimThreadCycleT	32	Однопроходной цикл нарезания продольной резьбы токарным резцом. Результат - условная резьба. Z - координата определяющая длину резьбы. F мм/об шаг резьбы. Если подача не в мм/об будет выдано сообщение о ошибке
GrooveCycle	32	Однопроходной цикл нарезания продольной резьбы токарным резцом в фрезерном проекте. Результат - настоящая резьба
TurnThreadCCycle	92	Однопроходной модальный цикл нарезания токарной резьбы. Z - координата определяющая длину резьбы. F мм/об шаг резьбы. Если подача не в мм/об будет выдано сообщение о ошибке
TurnChamferCycle	500	Фаска прямого угла под 45 градусов
TurnRoundCycle	501	Скругление прямого угла
MillCircCycle	*	*
MillCircInClearCycle	*	*
MillCircInCycle	*	*
MillCircOutCycle	*	*
MillRectCenterCycle	*	*
MillRectCenterInClearCycle	*	*
MillRectCenterInCycle	*	*
MillRectCenterOutCycle	*	*
MillRectCornerCycle	*	*
MillRectCornerInCycle	*	*
MillRectCornerOutCycle	*	*
MillSlotInCycle	*	*
MillHoleClearClear	*	*
PredefinedCycle	5000	Вызвать активный цикл. Цикл активизируется символом DefineCycle
ArcTang	200	Дуга касательная к предыдущему отрезку
RotateCSABC	5200	Поворот только начала СК (ориентация осей новой СК не меняется) вокруг "СК цеха". Для Heidenhain CYCL DEF 19.1 A+45B+30C+35
MoveRotateCS	68	Поворот СК вокруг текущей точки на заданный угол вокруг указанной вектором оси и смещение новой СК. Оси новой СК повернутся. G68X_Y_Z_I_J_K_R_. R – УГОЛ ПОВОРОТА, IJK — вектор оси, XYZ – новое положение
MoveRotateCSCancel	69	Отмена поворота СК заданной в MoveRotateCS
Chamfer	*	Фаска для HH. ChamferSize
Round	*	Скругление для HH. RoundSize
DraftChamfer	*	Фаска Fanuc. ChamferSize
DraftRound	*	Скругление Fanuc. RoundSize
DefLimitsPos	24	Положительный предел перемещения на станке по указанным координатам
DefLimitsNeg	25	Отрицательный предел перемещения на станке по указанным координатам
ActivateLimits	26	Включение/выключение пределов перемещения на станке. Если после кода пусто, то режим выключается
TiltPlane	7	Наклон плоскости обработки заданием углов с СК заготовки. (G7  в стойке миллплюс). Новая плоскость обработки задается углами ABC с осями СК заготовки. Ось инструмента устанавливается перпендикулярно новой плоскости обработки. Вычисленные углы поворота записываются в регистры определенные в A7B7C7. Формат: G7 {A5=.. or A6=..} {B5=.. or B6=..} {C5=.. or C6=..} {A7=..} {B7=..} {C7=..} {B47=..} {L1=..} {L..}, где A5 – TiltA, A6 - TiltAI, B5 - TiltB, B6 - TiltBI, C5 - TiltC, C6 - TiltCI, A7 - ProgramCopyStart, B7 - TiltBReg, C7 - TiltCReg, B47 - TiltMainAngleReg, L1 - TiltType, L - TiltToolOffset
PlaceTool	6000	Поставить инструмент в заданную позицию и наклонить инструмент вдоль указанного вектора. G6000XYZIJKL. XYZ – координата точки в СК заготовки, IJK вектор в СК заготовки, L – PlaceToolAxes
StockCompOn	*	Включить компенсацию заготовки выключенную кодом StockCompOff
StockCompOff	*	Если в станке компенсация заготовки включена, то этим кодом ее можно выключить
ToolCompOn	43	Включить смещения заданные в станке для инструмента «Компенсация инструмента» и в диалоге задания вылет инструмента «Автомат». По умолчанию код включен. Если включен код, то инструмент при смене появляется в станке и станок отъезжает для автоматического включения коррекции на длину
ToolCompOff	*	Выключить смещения заданные в станке для инструмента «Компенсация инструмента» и в диалоге задания вылет инструмента «Автомат». По умолчанию код включен. Этот код выключит авто компенсацию длины инструмента. Тогда вручную нужно поставить значение вылета в корректор и поставить смещение инструмента в диалоге
MachineCoordSys	79	Программирование относительно «0» станка. Не модальный (действует в одном кадре). «0» задается параметром MachineCS
DataSetting	10	Нет параметра. Слово в резерве, как аналог G10 Fanuc
// end section

// Section Misc Function Definition
Stop	0	Остановка программы по окончании обработки кадра без потери информации. Работа возобновляется нажатием пусковой кнопки (NCManager игнорирует эту команду)
OptionalStop	1	Остановка
SpindleCW	3	Включение вращения фрезерного шпинделя по часовой стрелке
SpindleCWTurn	3	Вращение токарного шпинделя по часовой стрелке
SpindleCCW	4	Вращение фрезерного шпинделя против часовой стрелки
SpindleCCWTurn	4	Вращение токарного  шпинделя против часовой стрелки
SpindleStop	5	Остановка шпинделя и фрезерного и токарного
SpindleStopMill	305	Остановка шпинделя фрезерного
SpindleStopTurn	5	Остановка шпинделя токарного
ToolChange	6	Смена инструмента. Если в разделе "Others" ключевое слово ToolChangeWithM06 имеет значение Yes, то по команде ToolChange происходит смена инструмента, иначе ToolChange не используется
CoolantFlood	8	Включение охлаждения жидкостью
CoolantMist	7	Включение туманной системы охлаждения (или продувка воздухом)
CoolantOff	9	Отключение охлаждения
Orient	19	Ориентация шпинделя. Остановка шпинделя с ориентацией. Шпиндель остаётся на той же механической ступени, что и раньше
EndProgram	30	Конец ленты. Должен присутствовать в файле, иначе не работает MainInitStr
SubroutineCall	98	Вызов подпрограммы
SubroutineCallN	97	Вызов подпрограммы по номеру кадра
SubroutineEnd	17	Конец подпрограммы. Если встречается в самой внешней программе, то выполнение всей программы заканчивается
SubroutineEndCont	17	Конец подпрограммы. Если встречается в самой внешней программе, то игнорируется, т.е. выполнение программы продолжается
GoTo	97	Безусловный переход. Выполнение программы продолжится с кадра, номер которого будет задан после символа ProgramNumber. Поиск этого кадра осуществляется в текущем блоке (подпрограмме), т.е. вверх и вниз по тексту до ближайших символов ProgramBeginEnd или начала/конца текста. GoTo – ищет вниз затем вверх
GoToForward	97	Безусловный переход. Выполнение программы продолжится с кадра, номер которого будет задан после символа ProgramNumber. Поиск этого кадра осуществляется в текущем блоке (подпрограмме), т.е. вверх и вниз по тексту до ближайших символов ProgramBeginEnd или начала/конца текста. GoToForward — только вниз
GoToBackward	97	Безусловный переход. Выполнение программы продолжится с кадра, номер которого будет задан после символа ProgramNumber. Поиск этого кадра осуществляется в текущем блоке (подпрограмме), т.е. вверх и вниз по тексту до ближайших символов ProgramBeginEnd или начала/конца текста. GoToBackward — только вверх
GoToNext	97	Безусловный переход. Аналогично GoTo, но переход будет осуществлен на кадр, следующий за тем, который был бы найден GoTo
GoToNextForward	97	Безусловный переход. Аналогично GoTo, но переход будет осуществлен на кадр, следующий за тем, который был бы найден GoTo
GoToNextBackward	97	Безусловный переход. Аналогично GoTo, но переход будет осуществлен на кадр, следующий за тем, который был бы найден GoTo
GoToProg	97	Безусловный переход. Аналогично GoTo, но переход будет осуществлен на кадр, по правилам вызова подпрограммы
FileCall	97	Вызов подпрограммы из файла. Буква для ProgramNumber. M97P "имя файла" (в кавычках)
FixX	81	Зажим координаты X
UnFixX	80	Отжим координаты X
FixY	83	Зажим координаты Y
UnFixY	82	Отжим координаты Y
FixZ	85	Зажим координаты Z
UnFixZ	84	Отжим координаты Z
FixA	81	Зажим координаты A
UnFixA	80	Отжим координаты A
FixB	83	Зажим координаты B
UnFixB	82	Отжим координаты B
FixC	85	Зажим координаты C
UnFixC	84	Отжим координаты C
AutoCycleEnd	20	Конец повторяющегося участка программы. Начало этого участка - кадр, содержащий символ, интерпретируемый в разделе "Word Definition" как RepeatNumber
NonModalCycleCall	99	Определить немодальный активный цикл. Вызванный модальный цикл станет немодальным (проработает и отменится)
SubroutineCallEnd	*	Вызванная подпрограмма заканчивается либо кодом конца ПП, либо кадром её вызова
StoreToolParams	8100	Параметры текущего инструмента как инструмента в формате APT7 запишет в регистры 8101-8107. #8101 - диаметр, #8102 – CORNER_R, #8103 - Elens, #8104 - FLENS, #8105 - BottomAngle, #8106 - SIDEANGLE, #8107 – Height
SetNextTool	0	Загрузить инструмент с следующим номером. Если в стойке нет смены инструмента
HhToolCallDef	500	Для задания величины смещения в стойке Heidenhain при определении инструмента. TOOL CALL DR+1 – меняется на структуру M500LG03 заменой в стойке и интерпретируется как присвоение значения +1 в регистр с номером 9201. Регистр 9201 можно использовать при вычислении величины коррекции когда коррекция включается
WhileStart	*	Начало цикла While. Нужно заменить слово While на этот M код. Нужно заменить DO с номером на M код GoToNext и ProgramCopyStart с номером кадра. Replace "WHILE" "M1000", Replace "DO1" "M66P111"
WhileEnd	*	Конец цикла While. Нужно заменить ENDn на номер кадра на который ссылается GoToNext в WhileStart и этот M код. Replace "END1" "N111M2000"
ForStart	*	Включить режим отладки УП и записать в регистр 8999=1. Изначально значение в регистре 8999 зависит от значения флага. Отладка в исходном состоянии стойки ЧПУ. Управляя значением регистра и выполняя этот M код, можно управлять этим флагом из УП
ForRegister	*	Включить режим отладки УП и записать в регистр 8999=1. Изначально значение в регистре 8999 зависит от значения флага. Отладка в исходном состоянии стойки ЧПУ. Управляя значением регистра и выполняя этот M код, можно управлять этим флагом из УП
ForEndValue	*	Включить режим отладки УП и записать в регистр 8999=1. Изначально значение в регистре 8999 зависит от значения флага. Отладка в исходном состоянии стойки ЧПУ. Управляя значением регистра и выполняя этот M код, можно управлять этим флагом из УП
ForStartValue 	*	Включить режим отладки УП и записать в регистр 8999=1. Изначально значение в регистре 8999 зависит от значения флага. Отладка в исходном состоянии стойки ЧПУ. Управляя значением регистра и выполняя этот M код, можно управлять этим флагом из УП
ForEnd	*	Включить режим отладки УП и записать в регистр 8999=1. Изначально значение в регистре 8999 зависит от значения флага. Отладка в исходном состоянии стойки ЧПУ. Управляя значением регистра и выполняя этот M код, можно управлять этим флагом из УП
DebugOn	*	Включить режим отладки УП и записать в регистр 8999=1. Изначально значение в регистре 8999 зависит от значения флага. Отладка в исходном состоянии стойки ЧПУ. Управляя значением регистра и выполняя этот M код, можно управлять этим флагом из УП
DebugOff	*	Выключить режим отладки УП и записать в регистр 8999=0. См описание DebugOn
GrooveOn	136	Включить режим резания токарным резцом без включения токарного шпинделя. Загатовка при этом считается фрезерной
GrooveOff	137	Выключить режим включенный кодом GrooveOn
PolarHelix	999	Включает расчет числа витков спирали при круговой интерполяции в случае если угол дуги задан относительным полярным углом (PolarAngleInc)
ClearAllRegisters	1000	Обнулить значения всех регистров. Действие такое же как при выполнении команды Сброс в NCManager
ErrorMessage	22	Выдать сообщение об  ошибке. Если после этого кода написано слово, то оно появится в сообщении об ошибке
TRTPositiveCCW	*	Управление типом вращения поворотной оси. Делает тоже что параметр TableRotationType
TRTPositiveCW	*	Управление типом вращения поворотной оси. Делает тоже что параметр TableRotationType
TRTAlwaysCCW	*	Управление типом вращения поворотной оси. Делает тоже что параметр TableRotationType
TRTAlwaysCW	*	Управление типом вращения поворотной оси. Делает тоже что параметр TableRotationType
TRTShortestDistance	*	Управление типом вращения поворотной оси. Делает тоже что параметр TableRotationType
TRTLinear	*	Управление типом вращения поворотной оси. Делает тоже что параметр TableRotationType
TRTDoNotChange	*	Управление типом вращения поворотной оси. Делает тоже что параметр TableRotationType
RestartRotAngles	*	Текущее значение угла пересчитать в диапазон 0-360 градусоа. Если угол равен 1440 град., то после выполнения команды он будет равен 0 град.
ThreadCut	12	Кадр с этим кодом режет в конце движения. Ранее требовался для симуляции токарных резьбовых циклов и строил условную резьбу. Для моделирования резьбы в токарке, условно. Режет только в конце кадра в котором встречается. Чтобы построить модель уловной резьбы, нужно разбить перемещение в кадре длиной равной шагу резьбы
VariablesDecl	120	Аналог декларации переменных в стойке Sinumerik. После кода следуют имена переменных через запятую. M120 AA12, __VAR2, VAR_NN. В разделе Other должен быть определен параметр: VarRegExp, иначе будет выдано сообщение об ошибке. Параметр VarTestExp описывает запрещенный формат переменной регулярным выражением. Должны быть определены буквы: VariablePrefix и VariableEnd
DefinesDecl	130	Определить макрос. Аналог DEFINE AS в стойке Sinumerik 	Формат команды: M130 Имя Макроса символ ',' какие то коды УП. Например: M130 OTHOD, G91G0Z10. В УП по слову OTHOD формируется движение G91G0Z10
DummyN	*	Пустая команда. Если в разделе "Misc Function Definition" есть строка такого вида: DUMMYN A (N И A - ЛЮБЫЕ ЧИСЛА) то вспомогательная функция, номер которой равен A, не будет обрабатываться программой NCManager
// end section

// Section Others
3DDiaCompensation	Yes/No (No)	Трехмерная коррекция
AlwaysIncremental	Yes/No (No)	Всегда размеры в приращениях. Программирование только в относительных координатах
CircleCenterMode	Absolute/Incremental/AsCoord (Incremental)	Режим центра дуги. В каких координатах программируется центр дуги - в абсолютных или относительных
CircleCenterType	IJR/IJ/R/ABSIJ (IJ)	Тип центра дуги. Как программируется центр дуги - координатами или радиусом
CircleInQuadrants	Yes/No (No)	Дуга разбита на квадранты. Если значение - Yes, то нельзя программировать дугу, начальная и конечная точки которой лежат в разных квадрантах
CodedFeed	Yes/No (No)	Кодированная подача. Если значение - Yes, то, встретив в управляющей программе выражение вида Fabcd (a, b, c, d - цифры), NCManager получает из него значение подачи по следующей формуле: F = 10*cd, где F - значение подачи, (ab) и (cd) - числа, образованные цифрами a, b, c и d. Например, из выражения F0344 значение подачи получается равным 10*44 = 0.44
ContinuedCircleStatement	Yes/No (No)	*
DecimalConversion	Целое число. Например 3 100/10**3	Десятичное преобразование. Прочитанное в программе число, которое может быть с десятичной точкой анализируется и если в нем нет точки то оно делится на коэфф. Если точек больше одной, то выдается сообщение о ошибке, если точка одно то число на коэфф не умножается
FeedDecimalConversion	Число (0)	Масштабирование подачи. Значение - число, определяющее масштабный коэффициент для подачи. Значение масштабного коэффициента вычисляется таким образом: Если задано число без десятичной точки, то масштабный коэффичиент m = 10 , где A - значение параметра FeedDecimalConversion, а m - масштабный коэффициент. Числовое значение подачи, встречающееся в управляющей программе, умножается на m (например, если A = 2, то происходит умножение на 0,01). Получившееся число и будет истинным значением подачи, которое обработает станок
FeedDotDecimalConversion	*	*
SpeedDotDecimalConversion	*	*
FileExtension	*	Расширение файла. Расширение файлов управляющих программ. Значение должно иметь вид: *.? где вместо вопросительного знака должны быть символы расширения (например *.tap). По умолчанию в диалоговом окне открытия файла программы в поле "ТИП ФАЙЛОВ" будет стоять это расширение. Если нужно несколько расширений, то они пишутся через ";" без пробелов
LinearDecimalConversion	Число (0)	Масштабирование линейной координаты. Значение - число, определяющее масштабный коэффициент для линейной координаты. Значение масштабного коэффициента вычисляется таким образом: Если задано число, то масштабный коэффициент m = 10, где A - значение параметра LinearDecimalConversion. Числовое значение линейной координаты (например X), встречающееся в управляющей программе, умножается на M (например, если A = 2, то происходит умножение на 0,01). Получившееся число и будет значением линейной координаты, которое обработается параметром LinearXConversion, LinearYConversion или LinearZConversion (в зависимости от того, какая координата - X, Y или Z) раздела "Others". Если же задано число с десятичной точкой, то значением масштабного коэффициента будет само это число
LinearXConversion	Число (0)	Масштабирование координаты X. Значение - число, определяющее масштабный коэффициент для координаты X. Значение масштабного коэффициента вычисляется таким образом: Если задано число, без десятичной точки то масштабный коэффициент m = 10, где A - значение параметра LinearXConversion, а m - масштабный коэффициент. Числовое значение координаты, получившееся в результате действия параметра LinearDecimalConversion раздела "Others", умножается на M (например, если A = 2, то происходит умножение на 0,01). Получившееся число и будет истинным занчением координаты, которое обработает станок. Если же задано число с десятичной точкой, то значением масштабного коэффициента M будет само это число
LinearYConversion	Число (0)	Масштабирование координаты Y. Значение - число, определяющее масштабный коэффициент для координаты Y. Значение масштабного коэффициента вычисляется таким образом: Если задано число, без десятичной точки то масштабный коэффициент m = 10, где A - значение параметра LinearYConversion, а m - масштабный коэффициент. Числовое значение координаты, получившееся в результате действия параметра LinearDecimalConversion раздела "Others", умножается на M (например, если A = 2, то происходит умножение на 0,01). Получившееся число и будет истинным занчением координаты, которое обработает станок. Если же задано число с десятичной точкой, то значением масштабного коэффициента M будет само это число
LinearZConversion	Число (0)	Масштабирование координаты Z. Значение - число, определяющее масштабный коэффициент для координаты Z. Значение масштабного коэффициента вычисляется таким образом: Если задано число, без десятичной точки то масштабный коэффициент m = 10, где A - значение параметра LinearZConversion, а m - масштабный коэффициент. Числовое значение координаты, получившееся в результате действия параметра LinearDecimalConversion раздела "Others", умножается на M (например, если A = 2, то происходит умножение на 0,01). Получившееся число и будет истинным занчением координаты, которое обработает станок. Если же задано число с десятичной точкой, то значением масштабного коэффициента M будет само это число
LinearIConversion	*	Число без знака / число с точкой и знаком. Если не задано, то значением по умолчанию принимается значение LinearXConversion. Значения для компонентов дуг I, J, K будут умножаться на числа заданные этими параметрами. Значение число без знака - умножение будет на 10 в степени указанной этим числом. Значение число с точкой и знаком - умножение будет на это число
LinearJConversion	*	Число без знака / число с точкой и знаком. Если не задано, то значением по умолчанию принимается значение LinearXConversion. Значения для компонентов дуг I, J, K будут умножаться на числа заданные этими параметрами. Значение число без знака - умножение будет на 10 в степени указанной этим числом. Значение число с точкой и знаком - умножение будет на это число
LinearKConversion	*	Число без знака / число с точкой и знаком. Если не задано, то значением по умолчанию принимается значение LinearXConversion. Значения для компонентов дуг I, J, K будут умножаться на числа заданные этими параметрами. Значение число без знака - умножение будет на 10 в степени указанной этим числом. Значение число с точкой и знаком - умножение будет на это число
LinearDecimalZero	Число (бесконечность)	Допуск определения нуля. Если модуль координаты меньше этого значения, то координата приравнивается 0
MaxArcRadius	Число (бесконечность)	(Не реализован). Максимальный радиус дуги, который можно программировать
MaxFeedRate	Число (100000)	Максимальная рабочая подача. Перемещения, осуществляемые на более высокой подаче, отображаются как холостой ход
MinArcDist	Число (2)	Минимальное расстояние начало-конец дуги. Если расстояние между двумя точками меньше этого значения, то точки считаются совпадающими. Допускаемая погрешность определяется так же, как масштабный коэффициент в LinearDecimalConversion
ModalArc	Yes/No (Yes)	Модальная дуга. Если Yes, то команды дуг действуют до встречи одной из команд (Rapid, Linear, CircularCW или CircularCCW) из раздела "Function Definition", отменяющей их. Если No, то команды дуг действуют только в своем кадре
ModalRapid	Yes/No (Yes)	Модальное быстрое перемещение. Если Yes то команда быстрого перемещения действуют до встречи одной из команд (Rapid, Linear, CircularCW или CircularCCW) из раздела "Function Definition", отменяющей их. Если No, то команда действует только в своем кадре
RotaryDecimalConversion	Число (0)	Масштабирование угловой координаты. Значение - число, определяющее масштабный коэффициент для угловой координаты. Значение масштабного коэффициента вычисляется таким образом: Если задано число без десятичной точки, то масштабный коэффициент m = 10, где A - значение парамерта RotaryDecimalConversion, а m - масштабный коэффициент. Числовое значение угловой координаты, встречающееся в управляющей программе, умножается на M (например, если A = 2, то происходит умножение на 0,01). Получившееся число и будет истинным значением угловой координаты, которое обработает станок
SpeedDecimalConversion	Число (0)	Масштабирование скорости вращения шпинделя. Значение - число, определяющее масштабный коэффициент для скорости вращения шпинделя. Значение масштабного коэффициента вычисляется таким образом: Если задано число без десятичной точки, то масштабный коэффициент m = 10, где A - значение парамерта SpeedDecimalConversion, а m - масштабный коэффициент. Числовое значение скорости вращения шпинделя, встречающееся в управляющей программе, умножается на M (например, если A = 2, то происходит умножение на 0,01). Получившееся число и будет истинным значением скорости вращения шпинделя, которое обработает станок
StartProgram	First/Last/Ignore (First)	Значение определяет, с какого кадра начнет действовать управляющая программа. Если значение - Last, то начало - последняя подпрограмма; если First, то первая; если Ignore, то начало - первый кадр самой программы (в этом случае игнорируется параметр ProgramBeginEnd)
ToolChangeWithM06	Yes/No (No)	Значение должно обязательно присутствовать в файле. Сменя инструмента с M06. Значение Yes определяет, что смена инструмента будет производиться по команде ToolChange раздела "Misc Function Definition", иначе смена инструмента происходит по команде ToolCode раздела "Word Definition"
ToolIndex	String/Absolute (Absolute)	Номер инструмента. String - инструмент задается именем в кавычках. Перенесено из SinumerikStyle. Absolute - номер иструмента задано числом
ToolOffsetInToolNumber	Com/Yes/No/For (No)	Номер корректора равен номеру инструмента. Если Yes, то при выборе инструмента автоматически выбирается и корректор с тем же номером. Если Com, то номер корректора следует за номером инструмента через точку. Например Т02.003 означает инструмент 2, корректор 3. Если For, то номер корректора следует за номером инструмента без точки. Формат записи этих номеров определяется параметром ToolNumFormat
ToolPreSelect	Yes/No (No)	Значение должно обязательно присутствовать в файле. Предварительный выбор инструмента. Если значение этого параметра - Yes, то по команде, осуществляющей смену инструмента, инструмент "ставится на подготовку", а работать начинает инструмент, который до этого был "поставлен на подготовку"
MainInitStr	*	Команда по умолчанию. Значение этого параметра - кадр управляющей программы, который будет автоматически выполняться перед началом любой программы. Чтобы работал, в стойке должны присутствовать — EndProgram. Например: MainInitStr G1. Эта строка означает, что по умолчанию включен режим "Программирование отрезка"
DwellTimeDiscr	Целое число (10)	Шаг по времени. Значение - целое число, определяющее масштабный коэффициент для времени выдержки. Значение масштабного коэффициента вычисляется таким образом: m = 0,001*A , где A - значение параметра DwellTimeDiscr, а m - масштабный коэффициент. Таким образом, если время выдержки задается, например, в десятых долях секунды, то значение параметра DwellTimeDiscr должно равняться 100
PartialCompCancel	Yes/No (Yes)	Не полное выключение коррекции. Если режим включен (значение Yes), то коррекция выключается только по тем координатам, по которым осуществляется перемещение
CycleNeedsGeom	Yes/No (Yes)	Включение цикла с перемещением. Если в кадре, в котором включается цикл отсутствует перемещение, то цикл включается, но не выполняется в этой точке
PutFirst	Список кодов, разделенных запятыми	Переместить в начало. Задается список кодов, которые (если присутствуют в кадре) должны быть выполнены в начале интерпретации этого кадра
EmptyZero	Yes/No (No)	Возможность опустить нулевое значение. Если задано Yes, то запись XY10 эквивалентна записи X0Y10
EmptyGZero	Yes/No (No)	Возможность опустить нулевое значение у G00 кода. Если задано Yes, то запись GY10 эквивалентна записи G0Y10
CheckGeom	Yes/No (Yes)	Проверка геометрии. Осуществляется дополнительная проверка корректности задания дуг. Допускаемая погрешность определяется параметром MinArcDist
CompToIntersect	Yes/No (No)	Коррекция до пересечения устарели использовать CompType. Траектория с учетем коррекции рассчитывается до пересечения со следующим кадром
MiChechLengthComp	Yes/No (No)	Дополнительная проверка включения коррекции на длину. Сообщение об ошибке выдается, если при первом перемещении по Z после смены инструмента не включена коррекция на длину инструмента
MiCheckIJKRDef	Yes/No (No)	Дополнительная проверка наличия IJKR. Сообщение об ошибке выдается если в кадре с круговой интерполяцией не задано ни I ни J ни K ни R
MiCheckSpindleOff	Yes/No (No)	Дополнительная проверка включен ли шпиндель при движении инструмента на рабочем ходу. Сообщение об ошибке выдается если в кадре задано движение на рабочей подаче, а инструмент или токарный патрон не включен
MiCheckZeroFeed	*	Дополнительная проверка включена ли подача при движении на рабочем ходу. Сообщение об ошибке выдается если в кадре задано движение на рабочей подаче, а значение подачи равно "0"
MirrorRotateType	Absolute/Incremental (Incremental)	Тип симметрии/поворота. Заданная симметрия/поворот применяется к координатам (Absolute) или перемещениям (Incremental)
IncrRebOp	Yes/No (No)	Операции с регистрами в приращениях
CompWithArcs	Yes/No (No)	Дополнительные дуги в углах - устарели использовать CompType. При включенной контурной коррекции на выпуклых углах вставлять дуги
SpiralG2G3	Yes/No (No)	Разрещение линейно-круговой интерполяции. Если Yes, то линейно-круговая интерполяция разрешена для кодов CircularCW и CircularCCW. Если No, то только для кодов SpiralCW и SpiralCCW
MiCheckLengthOffsetNum	Yes/No (No)	Дополнительная проверка совпадения номера инструмента и номера корректора на длину. Сообщение об ошибке выдается, если при первом перемещении по Z после смены инструмента, номер корректора на длину не совпадает с номером инструмента
MiCheckDiamOffsetNum	Yes/No (No)	Дополнительная проверка совпадения номера инструмента и номера корректора на диаметр. Сообщение об ошибке выдается, если при включении коррекции на диаметр (G41, G42) номер корректора не равен номеру инструмента + значение, заданное в параметре NumForDiamOffset
NumForDiamOffset	Целое число (30)	Число для определения номера корректора на длину
DeltaFace	Число (0)	Велечина отступа в токарном цикле
DeltaCutting	Число (0)	Велечина отступа в токарном цикле
ToolNumFormat	Строка (N6L0)	Формат номера инструмента. N[x1]L[x2], где x1 - число из одной цифры, определяющее количество цифр в номере инструмента; x2 - число из одной цифры, определяющее количество цифр в номере корректора. Например: N2L2 означает, что первые 2 цифры определяют номер инструмента, а следующие две - номер корректора
IgnoreUnknownG	Yes/No (No)	Игнорировать неизвестные G-коды
IgnoreUnknownM	Yes/No (No)	Игнорировать неизвестные M-коды
IgnoreUnknownCh	Yes/No (No)	Игнорировать неизвестные символы
RegenProgIfToolChange	Yes/No (No)	Регенерировать программы при смене инструмента
KeepUCSDisp	Yes/No (No)	Сохранять смещение при смене рабочей системы координат
EnableOrtChamfer	Yes/No (No)	Разрешить ортогональную фаску
InterChangeCancelCycle	Yes/No (No)	Прервать цикл кодом G0 G1 G2 G3
DHCompEQ	Yes/No (No)	Номер H корректора совпадает с указанным в программе номером D корректора. Yes - если в программе включили D10 то значение H тоже равно 10. No - если в программе включили D10 то значение H осталось текущим
CyclicA	Yes/No (No)	Если значение параметра Yes, то стойка может вращать ось только на 360 градусов в соответствии с параметром TableRotationType
CyclicB	Yes/No (No)	Если значение параметра Yes, то стойка может вращать ось только на 360 градусов в соответствии с параметром TableRotationType
CyclicC	Yes/No (No)	Если значение параметра Yes, то стойка может вращать ось только на 360 градусов в соответствии с параметром TableRotationType
TableRotationType	PositiveCCW/PositiveCW/AlwaysCCW/AlwaysCW/ShortestDistance/Linear (Linear)/DoNotChange	Тип вращения стола. PositiveCCW - знак направления вращения: плюс = CCW, минус = CW, а значение угла означает абсолютное положение угла поворота; PositiveCW - то же что и PositiveCCW, только направление вращения противоположное; AlwaysCCW - значение угла вращения означает абсолютное положение угла поворота. Направление поворота всегда CCW; AlwaysCW - то же что и AlwaysCCW, только направление вращения противоположное; ShortestDistance - значение и знак поворота означает конечную позицию поворота. Направление поворота зависит от кратчайшего расстояния до конечной позиции; Linear - положительное направление вращения CCW, отрицательное CW; DoNotChange - не изменять направление, т.е. поведение такое как если бы были выключены параметры Cyclic_
SubrCallFormat	G98P1020340 - при формате: N4L2 - 1020, вызывается 340 раз; L2N4 - 0340, вызывается 102 раза	Формат вызова подпрограммы с повторами. N[X1]L[X2], L[X1]N[X2], где N[X1] - количество цифр в номере программы; L[X2] - количество цифр повтора подпрограммы
ToolChangeTime	G98P1020340 - при формате: N4L2 - 1020, вызывается 340 раз; L2N4 - 0340, вызывается 102 раза	Время на смену инструмента (сек)
FastFeedRate	12000	Скорость холостого перемещения (мм/мин; дюйм/мин)
FeedInLine	Yes/No (No)	Подача внутри. Значение Yes - при активной CircularCWM, если встретилась F, то неистолняемый кадр увеличивается на одну строку
CycleZAbs	Yes/No (No)	Для циклов аркоматик фрезерных - координата Z в цикле относительная или абсолютная велечина. (относительная)
MiCheckXYChamf	*	Наличие XY в фаске и скруглении
CheckLBLRepeat	Yes/No (No)	Повтор подпрограммы для стойки Haidenhain
MiCheckDiamCompOff	Yes/No (No)	Дополнительная проверка выключения контурной коррекции. Ошибка выдается если коррекция включена при смене инструмента
SkipSubroutine	Yes/No (No)	Невыполнять ПП, если она встретилась в теле основной программы
FAC_XY_CLR	*	Для фрезерных циклов значение недобега
CompType	Default/Arc/Int/InternalInt (Default)	Вместо устаревших CompToIntersect и CompWithArcs. Переключает тип контурной коррекции. Default - смещение без учета следующего кадра; Arc - дополнительные дуги на внешних углах; Int - до пересечения со следующим кадром; #8200 - только внутренные углы до пересечения со следующим кадром
UseStdFuncNames	Yes/No (No)	Включит выключить поддержку стандартных имен функций (SIN COS SQRT ...) "-+*/[]^$<>=!?&|:". Если включено и имена функций стандартные, то замен на специальные символы делать не надо. Стандартные имена: SIN COS TAN ATAN SQRT ABS FUP FIX ROUND REG ASIN=j ACOS=k LN=l EXP=m. text.Replace("LT","<"); text.Replace("LE","?"); text.Replace("GT",">"); text.Replace("GE","!"); text.Replace("EQ","="); text.Replace("NE",":"); ~ - отрцание, ^ - возведение в степень, $ - остаток от деления (или по модулю), | - логическое или, & - логическое и, : - отрицание
‘	X[1000'360]	Символ апострофа. Целое деление
@28	*	Записать значение в регистр, значение которого находится в указанном регистре. В примере - регистр 10: #10@28
REG	*	Прочитать значение указанного регистра. В примере - регистр 10: REG#10
e	*	Прочитать значение указанного регистра. В примере - регистр 10: REG#10
IgnoreCadrContaining	*	Игнорировать кадр содержащий эту строку
ExprGCode	Yes/No (No)	Включить/выключить возможность задать номер G кода из регистра. #45=5, G#45
ExprMCode	Yes/No (No)	Включить/выключить возможность задать номер M кода из регистра. #45=5, M#45
AddCoord00Axis	*	Имя дополнительной оси в станке будет соответствовать букве в программе заданной в параметре AddCoord00 00, 01, 02, порядковый номер
HorizontalAxisMinDef	-1000.0	Минимальный предел перемещения по умолчанию. Синтаксис такой же, как для масшбатных коэффициентов
HorizontalAxisMaxDef	1000.0	Максимальный предел перемещения по умолчанию. Синтаксис такой же, как для масшбатных коэффициентов
VerticalAxisMinDef	-1000.0	Минимальный предел перемещения по умолчанию. Синтаксис такой же, как для масшбатных коэффициентов
VerticalAxisMaxDef	1000.0	Максимальный предел перемещения по умолчанию. Синтаксис такой же, как для масшбатных коэффициентов
SpindleAxisMinDef	-1000.0	Минимальный предел перемещения по умолчанию. Синтаксис такой же, как для масшбатных коэффициентов
SpindleAxisMaxDef	1000.0	Максимальный предел перемещения по умолчанию. Синтаксис такой же, как для масшбатных коэффициентов
HorizontalRotationAxisMinDef	-1000.0	Минимальный предел перемещения по умолчанию. Синтаксис такой же, как для масшбатных коэффициентов
HorizontalRotationAxisMaxDef	1000.0	Максимальный предел перемещения по умолчанию. Синтаксис такой же, как для масшбатных коэффициентов
VerticalRotationAxisMinDef	-1000.0	Минимальный предел перемещения по умолчанию. Синтаксис такой же, как для масшбатных коэффициентов
VerticalRotationAxisMaxDef	1000.0	Максимальный предел перемещения по умолчанию. Синтаксис такой же, как для масшбатных коэффициентов
SpindleRotationAxisMinDef	-1000.0	Минимальный предел перемещения по умолчанию. Синтаксис такой же, как для масшбатных коэффициентов
SpindleRotationAxisMaxDef	1000.0	Максимальный предел перемещения по умолчанию. Синтаксис такой же, как для масшбатных коэффициентов
ContextFeed	Yes/No (No)	Включить/выключить режим задания подачи мм/мин или об/мин в зависимости от типа перемещения. Если подача включается в кадре с поворотной осью, то велечина подачи в об/мин
PartFastInterp	Yes/No (No)	Не работает!!! При холостых перемещениях сначало Z затем XY
IfStrAdd	*	Приписывается в конец строки с IF или IN если условие выполнено
IfNotStrAdd	*	Заменяет строку с IF или IN если условие не выполнено
CycleNeedsParam	Yes/No (No)	Если Yes, то при изменении Z R1 R2 в не первой строке, цикл будет работать
ForcedCycles	Yes/No (No)	Если Yes, то любой цикл будет выполнятся только в кадре с G-кодом включения цикла (т.е. цикл станет не модальным)
MakeUpper	Yes/No (No)	Если Yes, то считать что все буквы в УП в верхних регистрах, тогда A=a, X=x, и т.д. Если No, то большие и маленькие буквы в УП считаются разными буквами
BaltSysStyle	Yes/No (No)	Включить обработку 3-x буквенных кодов стойки NC-110. Будет поддержаны следующие коды: BNC, BLE, BGT, BLT, BEQ, BNE, BGE, EPP, CLS... Должны быть определены G/M коды: GoTo, ProgramCopy, FileCall. Слова: ProgramNumber, ProgramCopyStart, ProgramCopyEnd. Пояснения. Например, строка типа (EPP, L1, L2) будет преобразована внутри NCM в стандартный ISO код. G2000P"L1"Q"L2", где G2000 - ProgramCopy, P - ProgramCopyStart, Q - ProgramCopyEnd. Для стойки с вызовом подпрограммы из файла 1080, т.е. (CLS, 1080/DFDE) строка будет преобразована M97P"1080", где M97 - FileCall, P - ProgramNumber
SinumerikStyle	Yes/No (No)	1. Два IF в строке. 2. Инструмент по имени - T"имя" - обработка удалена и перенесена в параметр ToolIndex. Смена инструмента по TLCH1(«имя строка», B, A) и TLCH4H(«имя строка», B, D = Номер кромки  + 500) преобразуется в строку G кода. T”имя”M6B_A_ или T”имя”M6B_D500 + номер инструмента. 3. REPEAT UNTILL - цикл с условием в конце цикла. Автоматически заменяется UNTIL<условие> на строку IN<условие> GOTOB ITERATE. В заменах описать Replace "REPEAT" "ITERATE:". 4. Вызов подпрограммы по имени. Надо описать G-код вызова макро: CallMacro 1065. ModalCallMacro 1066. ModalCallCancel 1067. LabelFirst и LabelLast как кавычки. 5. MCALL + имя ПП, сделает подпрограмму модальной. Выключение нужно определить в заменах на G-код ModalCallCancel. 6. Повтор ПП - должна быть определена буква P как RepeatNumber. Пробелы не удаляются
LabelType	Empty/BaltSys/Sinumerik/Expression (Empty)	Включить обработку меток в стиле: BaltSys (стойки NC-110), т.е. слово в кавычках; Sinumeric - слово в начале строки (или после номера кадра), начинающееся с двух букв или подчеркиваний заканчивающееся «:» пробелы становятся разделителем; Expression - метка целое число либо регистр; Empty - метка целое число
MachineCS	X, Y, Z, A, B, C (0)	Значения СК относительно СК загатовки. Через «,» без пробелов
ModalSubNeedsParam	Yes/No (Yes)	*
ModalSubNeedsGeom	Yes/No (Yes)	*
FileProtection	Yes/No (No)	Учитывать или нет свойство показавать по кадровое выполнение файла с подпрограммами при выполнении. No - программа всегда показывается и свойство это не меняется. Yes - программа показывается или нет в зависимости от значений свойства
PolarCoordRecalc	Yes/No (No)	Разрешить пересчет текущих полярных координат (занимает время на расчет)
Translit	Yes/No (No)	Если включен, то помментарий латиницей при чтении заменяется кириллицей и наоборот, при сохранении УП кириллица заменится на латинские символы
SaveCoord2Reg	Yes/No (Yes)	*
SlindleReverseTime	*	Минимальное время на переключение направления вращения шпинделя в циклах нарезания резьбы метчиком. Когда CicleDwellTime равно "0" или меньше этого времени, то время на реверс берется из этого параметра
SyncroTime	*	Время на синхронизацию в токарных циклах нарезания резьбы резцом
TurnCutCycleMod	Yes/No (No)	Включает модальность параметров (XZR) в токарных циклах TurnFaceCycle, TurnFaceRoughCycle
TurnGroovDwell	*	*
DrillPeckDwell	*	Задержка времени в сверлильных циклах DrillPeckCycle при выходе на уровень R
ApplyReplacements	Yes/No (No)	Замены применяются для визуализации текста в NCManager при чтении файла УП. Флаг для отладки постпроцессора
LoadSubParams	Имена файлов через ",". FileMane1.Ext,FileName2.Ext,FileName3.Ext,...	В проект загрузятся подпрограммы имена которых указаны в параметре через запятую. ПП будет в статусе Защищена. Их можно сохранять, обновлять,... Файлы ПП должно находиться в той же папке, что и файлы стоек ЧПУ
ConsecutiveCalcP	Yes/No (No)	Если значение No, то вычисление выражения по общим правилам арифметики. Yes - вычисление последовательное
UseRegStack	Yes/No (No)	Включить стэк для регистров 1-33. Если включен, то регистры будут локальными для каждой подпрограммы. Номера регистров 50000 до 51000 заняты под стек
FastMovPolarInt	Yes/No (No)	Разрешить или нет холостой ход в режиме полярной интерполяции. Yes - разрешить. No - выдать сообщение об ошибке
VarRegExp	(%s);;x\1g	Описание замены для переменных в M-коде VariablesDecl. %s - имя. ;; - разделяют выражение на две части. Слева шаблон имени, справа подстановка к имени букв начала и конца имени переменной VariablePrefix, VariableEnd. Если нет параметра, то выдается ошибка, если в УП встретится M-код VariablesDecl
UseIntegerArithm	Yes/No (No)	Включить целочисленную арифметику. Тогда 1/3=0
VarTestExp	(SIN)|(COS)	Задать запрещенные имена переменных регулярным выражением. Если имя переменной соответствует этому регулярному выражению, то ошибка. Регистры в именах учитываются. Проверка производится при объявлении переменных в коде VariableDecl
OpenBracketChar	Символ [	Переопределить символ открывающей скобки в формулах. По умолчанию это символ "["
CloseBracketChar	Символ ]	Переопределить символ закрывающей скобки в формулах. По умолчанию это символ "]"
// end section